**********
*****XXXX*
*XXX*XXXX*
*XXX*XXXXX
XXX*******